Name,Math,Physics,Chemistry,Biology,English,Total,Average
Student 1,85,90,95,80,75,425,85.0
Student 2,78,82,88,90,85,423,84.6
Student 3,92,88,91,86,89,446,89.2
Student 4,75,80,79,92,88,414,82.8
Student 5,88,90,92,85,87,442,88.4
Student 6,82,84,86,88,90,430,86.0
Student 7,90,92,94,89,91,456,91.2
Student 8,85,87,85,80,82,419,83.8
Student 9,80,82,84,86,88,420,84.0
Student 10,92,94,96,98,90,470,94.0
